{
    "map": [
        [1, 1, 1, 1, 1, 1, 1, 1, 1, 1],
        [1, 0, 0, 1, 0, 1, 1, 0, 0, 1],
        [1, 0, 1, 1, 0, 1, 0, 1, 0, 1],
        [1, 0, 0, 0, 0, 1, 0, 1, 0, 1],
        [1, 0, 1, 1, 1, 0, 0, 0, 0, 1],
        [1, 0, 1, 0, 1, 0, 1, 1, 0, 1],
        [1, 0, 1, 0, 1, 1, 1, 0, 0, 1],
        [1, 0, 0, 0, 0, 1, 0, 0, 1, 1],
        [1, 0, 1, 1, 0, 0, 0, 1, 1, 1],
        [1, 1, 1, 1, 1, 1, 1, 1, 1, 1]
    ],
    "objects": {
        "entrance": [1, 8],
        "exit": [6, 5]
    },
    "properties": {
        "startLon": 180
    }
}
